 
 ********************************************************************************************************************************************************************
 *                                                                                                                                                                  *
 *                                                                                                                                                                  *
 *                                                                                                                                                                  *
 *                                                                                                                                                                  *
 *                                                                                                                                                                  *
 *                                                                                                                                                                  *
 *                                                                                                                                                                  *
 *                                                                                                                                                                  *
 *                                                                                                                                                                  *
 *                                                                                                                                                                  *
 *                                                                                                                                                                  *
 *                                                                                                                                                                  *
 *                                                                                                                                                                  *
 *                                                                                                                                                                  *
 *                                                                                                                                                                  *
 *                                                                                                                                                                  *
 *                                                                                                                                                                  *
 *                                                                                                                                                                  *
 *                                                                                                                                                                  *
 *                                                                                                                                                                  *
 *                                                                                                                                                                  *
 *                                                                                                                                                                  *
 *                                                                                                                                                                  *
 *                                                                                                                                                                  *
 *                                                                                                                                                                  *
 *                                                                                                                                                                  *
 *                                                                                                                                                                  *
 *                                                                                                                                                                  *
 *                                                                                                                                                                  *
 *                                                                                                                                                                  *
 *                                                                                                                                                                  *
 *                                                                                                                                                                  *
 *                                                                                                                                                                  *
 *                                                                                                                                                                  *
 *                                                                                                                                                                  *
 *                                                                                                                                                                  *
 *                                                                                                                                                                  *
 *                                                                                                                                                                  *
 ********************************************************************************************************************************************************************